*********
*  **FFF*
*1  *   *
*2      *
*3      *
*********
